1111111111111111111111111111111111
1E00000000000000000000000C00000001
1010010100100000101001000000010101
1010010010101010001001000000100101
1P000000000C000000P001000000000E01
1010010100100000101001000000010101
101001001010101000100100C00001P101
1P00000000000000000P00000000000001
1010010100100000101001000000010101
1010010010101010001001000000010101
1P0000000000000000000C000000000001
1111111111111111111111111111111111